#This is a translation file for FR
#Fri May 06 13:06:45 GMT+01:00 2011
MaximumRPM=Trs/Min maxi
CantheadaptertalkOKtothevehicleECU=L'adaptateur peut-il communiquer avec l'ECU ?
GeneralPreferences=Paramètres généraux
Unknown=Inconnu
VehicleWeightkg=Poids du véhicule (kg)
LogwhenTorqueisstarted=Enregistrer quand Torque démarre
Recordtrip=Enregistrer le voyage
Connectionsettings=Paramètres de connexion
Reducescreenframeratestosavebatterypower=Réduire le taux de rafraichissement pour économiser la batterie
Checkingmodel=Vérification du modèle...
Fuel&Airstatus=Etat essence & air
Passivebusmonitoringforfasterd969426590=Monitoring passif pour une acquisition plus rapide des données (peut ne pas marcher sur certains appareils)
Clearcurrenttrack=Effacer le trajet courant
UseFeet=Utiliser les Pieds
RotateLogfiles=Créer des fichiers de log uniques
ConfiguringOBDinterface=Configuration de l'interface OBD...
Startupindashboard=Démarrer en mode tableau de bord
Resettheme=Réinitialiser le thème
UseMiles=Utiliser les Miles
ShowyourTorqueID=Voir votre identifiant Torque
WebserverURL=Adresse du serveur web
AdjustBoost=Ajuster la pression du turbo
SetthefueltypeusedMPGcalculati1682843091=Définir le type de carburant utilisé (utile pour calculer la consommation)
Port=Port
Uploadtowebserver=Envoyer sur le serveur web
IPAddress=Adresse IP
Youcanturnthesetipsoffinthesettings=Vous pouvez désactiver ces astuces dans les paramètres
ConfirmQuit=Confirmer la fermeture
Sendcommsdebuglog=Envoyer les logs de debug
Speech/AlarmSettings=Voix
ResetthethemetotheTorquedefaulttheme=Réinitialiser le thème par défaut
UseUSGallons=Utiliser les Gallons Américains
NotconnectedtoOBDinterface\!Con2060245052=Non connecté à l'interface OBD\! Connectez-vous puis appuyez sur 'Rafraichir' dans le menu
Showhistoricfaults=Voir l'historique des codes défaut
Showtrackmap=Voir la carte du parcours
ManageextendedPIDs=Gérer les données étendues
OnlyifBTwasalreadyoff=Seulement si le Bluetooth était déjà éteint
DigitalDisplay=Affichage digital
Usefeetinsteadofmeters=Utiliser les Pieds au lieu des Mètres
ChoosethePIDsthatyouwishtologt1965240981=Choisir les données à enregistrer dans les fichiers et sur le serveur web. Plus vous en sélectionnez, plus le rafraichissement sera lent.
Thefirmwareversionoftheadapter=Version du firmware de l'adaptateur
MPGcalculationrequiresyourengi1811425423=Le calcul de la consommation a besoin du litrage de votre moteur (ex '1.6' pour un 1.6L)
ConnectedtoOBDinterfacequerying=Connecté à l'interface OBD, veuillez patienter
AdapterErrorCount=Nombre d'erreurs de l'adaptateur
Settings=Paramètres
Thisshouldstayon0ifnotthenyoup1139384169=Celà devrait rester à 0, sinon vous disposez peut-être d'un mauvais adaptateur.
AreyousureyouwanttoexitTorque=Êtes-vous sûr de vouloir quitter Torque ?
WifiPreferencesRootrequired=Réglages Wifi (accès root obligatoire)
RawDatadisplay=Affichage des données en ligne
SafetyWarnings=Alertes de sécurité
Quit=Quitter
Warnabouticyconditionsfuelleve40765125=Avertir à propos de la température, le niveau d'essence, ... si supporté par l'ECU.
USGallonsinsteadofImperialGallons=Gallons Américains au lieu des Gallons impériaux
AddsensorGreenactivesensor=Ajouter une sonde (Vert \= sonde active)
Onlyturnson/offBluetoothifitwa1698875973=Active/désactive le Bluetooth seulement si il était éteint lors du démarrage de l'application. Si le Bluetooth était déjà activé il ne sera pas désactivé lors de la fermeture de l'application.
AlwaysuploadGPS/OBDdatatoawebs36492282=Toujours envoyer les données GPS/OBD vers un serveur web lors de l'utilisation de l'application
MaximumBrightness=Luminosité maximale
Startingup=Démarrage...
OBDProtocol=Protocole OBD
VerbalAlarms=Alarmes verbales
WelcometoTorquepressthe'Menu'b1936927763=Bienvenue dans Torque, appuyez sur le bouton 'Menu' pour accéder aux paramètres
IdentifyingECUsinsystem=Identification de l'ECU dans le système
DisableELM327autotimingadjust=Désactiver l'ajustement automatique du timing pour ELM327
ManageAlarms=Gérer les alarmes
Graph=Courbe
Pausesloggingtothefilewhennotc2110813471=Suspendre l'enregistrement des données quand l'appareil est déconnecté de l'ECU
AlarmEditor=Editeur d'alarme
Protocol0appearstowork=Le protocole 0 semble fonctionner
Rotatethedialstofollowtheorien928292364=Faire tourner les manomètres suivant l'orientation de l'appareil
Loggingpreferences=Paramètres d'enregistrement
Freezethedisplayandallowsthesc921116199=Gèle l'affichage et permet à l'appareil de se mettre en veille quand il n'est pas branché à une alimentation extérieure, utilisé seulement dans l'écran 'données en temps réel'
FuelType=Type de carburant
Readthetermsofuseandprivacypol41288340=Lire les conditions d'utilisation et les mentions légales de Torque
Vehiclemake=Marque du véhicule \: 
GPSis*REQUIRED*forsomeoperatio1414046335=Le GPS est *REQUIS* pour certains affichages/opérations dans Torque. Cette option vous avertit si il est désactivé.
EngineDisplacementL=Litrage du moteur (L)
Don'tdisplaypsiasin/Hg=Ne pas afficher les psi en in/Hg
VehicleManufacturer=Marque du véhicule
IPAddressoftheWifiOBDAdapterRo1668941581=Adresse IP de l'adaptateur OBD Wifi (Hacks Root et Ad-Hoc requis)
CurrentDrivecyclestatus=Statut du cycle de conduite courant
Press'Menu'toaddextraOBDPIDstolog=Appuyez sur 'Menu' pour ajouter des sondes supplémentaires à enregistrer
Shownotificationbar=Montrer la barre de notification
Usemilesinsteadofkilometers=Utiliser les Miles au lieu des Kilomètres
Protocol7appearstowork=Le protocole 7 semble fonctionner
KMLPointsGoogleearth=Points KML (Google earth)
Fastercommunication=Communication plus rapide
TheprotocolusedtotalktothevehicleECU=Protocole utilisé pour le dialogue avec l'ECU du véhicule
Dial=Manomètre
VehicleCalibrationID=Identifiant de calibration du véhicule
Secondaryairstatus=Statut de la sonde d'air secondaire
Protocol7wasnotsuccessful=Le protocole 7 ne fonctionne pas
Hidethestatusbar=Cacher la barre de statut
AutoBluetoothOn/Off=Activation/désactivation automatique du Bluetooth
Setthedisplaytomaximumbrightne444799672=Règle l'affichage à la luminosité maximale lorsque Torque démarre
Attemptfastercommunicationswit558099082=Essaye de communiquer plus rapidement avec l'interface (peut ne pas marcher sur certains appareils)
AddAlarm=Ajouter une alarme
ThemaxseenPIDs/secondthathaveb1455220434=Maximum de données/seconde lues depuis l'ECU
Share=Partager
Don'tcalculateMPG/Fuel=Ne pas calculer la consommation de carburant
OBDIItoRS232Interpreter=Interpreteur OBDII vers RS232
ChooseBluetoothDevice=Choisir l'appareil Bluetooth
Fuelstatus=Niveau de carburant
UseCelsius=Utiliser les degrées Celsius
ShowsyourinitialIDforloggingin287891724=Affiche votre ID initial pour vous identifier sur le site de Torque
Cancel=Annuler
AllowtheOBDchiptogotosleepafte1361124593=Permet à la puce OBD de se mettre en veille au bout de 120secs d'inactivité et de voltage stable (<+/-0.1v) (economise la batterie si l'appareil reste connecté en permanence, pour l'OBDLink de ScanTool.net seulement)
Connectiontoadapter=Connexion à l'adaptateur
CalibrateAccelerometer=Calibrer l'accéléromètre
Usepsiinsteadofbar=Utiliser les Psi au lieu des Bar
AlarmTriggerValuein=Valeur de déclenchement de l'alarme en
CalibrationID=Identifiant de calibration 
Medium=Moyen
Areyouconnectedtothebluetoothadapter=Êtes-vous connecté à l'adaptateur Bluetooth ?
QuitTorque=Quitter Torque
Showthedashboardinsteadofthest1958017967=Monter le tableau de bord au lieu de l'écran de démarrage lors du lancement de l'application
Checkingprotocol=Vérification du protocole\: 
ResetTripCounters=Réinitialiser les compteurs de distance
Chooseatheme=Choisir un thème
Snaptogrid=Aligner sur la grille
Isthedevicebluetoothenabled=Est-ce que le Bluetooth de l'appareil est activé ?
ConnectedtoECUOK=Connecté à l'ECU.
Realtimewebupload=Upload en temps réel sur le web
Checkingvehiclemodel=Vérification du modèle du véhicule
OBD2/ELMAdapterpreferences=Paramètres de l'adaptateur OBD2/ELM
Torque&HPcalculationsrequireth2051144533=Les calculs de Puissance & Couple nécessitent le poids total du véhicule
Weblookup=Recherche sur le wen
LogPIDManagerDisplayingLoggedPIDs=Gestion des données à enregistrer - Affichage des données enregistrées
Choosebackgroundimage=Choisir une image d'arrière-plan
TheOBDstandardthatthevehicleEC504667872=La norme OBD auquel se conforme l'ECU du véhicule
CSVCommaseparatedvalues=CSV (Valeurs séparées par des points-virgules)
Youshouldonlyperformthisaction152292207=Vous devriez uniquement exécuter cette action après que le problème ait été fixé et que le véhicule soit à l'arrêt.\n\nSi le problème n'a pas été corrigé, le code défaut réapparaitra ou ne sera pas supprimé.\n\nAttention\: Certains véhicules ont besoin que le moteur soit à l'arrêt avant que les codes défaut puissent être réinitialisés\n\nÊtes-vous sûr de vouloir effacer les codes défaut ?
AdvancedSettings=Paramètres avancés
Showpendingfaults=Voir les codes défauts actifs
AdapterManufacturer=Fabricant de l'adaptateur
Clock=Horloge
Adjusttheboostforatmosphericpr1579540259=Ajuster la pression du turbo par rapport à la pression athmosphérique et les autres pressions - habituellement '0' ou '14.7' suffit
ConnectingtoOBDviabluetooth=Connexion à l'OBD via Bluetooth...
VINCode=Numéro de série
NotconnectedRetryingin60seconds=Non connecté. Nouvelle tentative dans 60 secondes...
KMLLinesGoogleearth=Lignes KML (Google earth)
Bluetoothbugwarning=Alertes de problèmes Bluetooth
Vehicleidentificationnumberche2038408290=Numéro de série du véhicule (vérifiez dans votre manuel)
Sharemapscreenshot=Partager cet aperçu de la carte
Speechpreferences=Paramètres de voix
Don'tshowthestatusbarifithasn'755292525=Ne pas montrer la barre de statut si elle n'a pas changé depuis quelques secondes.
Defaultprofile=Profil par défaut
OnlywhenOBDconnected=Seulement quand connecté à l'OBD
EmailLogs=Envoyer les logs par e-mail
Customview=Vue personnalisée
http//scriptURLwhereyouwanttou1284339533=Adresse http\:// du script auquel vous souhaitez envoyer les données enregistrées (doit répondre par 'OK\!') - défaut \:
ScanToolnetOBDLinkPowerSavings=Economie de batterie pour l'OBDLink de ScanTool.net
Torqueisidle=Torque est inactif
IPAddressxxxx=Adresse IP (x.x.x.x)
Privacypolicy&Terms=Mentions légales
Press'Menu'toaddalarms=Appuyez sur 'Menu' pour ajouter des alarmes
ShowbeginnerstipsonhowtouseTorque=Voir les astuces sur comment utiliser Torque
UseMonitorMode=Utiliser le mode Moniteur
Textmodereadings=Affichage en mode texte
Protocol6wasnotsuccessful=Le protocole 7 ne fonctionne pas
FileLogging=Enregistrement dans un fichier
EnableSpeech=Activer la voix
Usepsi=Utiliser les Psi
Cheapcloneversionsofthisadapte1015326145=Les versions peu chères de cet adaptateur (le plus souvent trouvées via Amazon/eBay) peuvent ne pas fonctionner avec le protocole J1850-PWM(Ford/autre), et peut aussi avoir des problèmes de mauvaises communications (ce qui aura pour effet de geler les manomètres ou autre).
SearchDatabase=Recherche dans la base de données
BluetoothEnabled=Bluetooth activé
DrivecyclestatussinceDTCclear=Statut de conduite depuis l'effacement des codes défaut
Unitpreferences=Paramètres d'unités
Defaultingtopaired'=Utilisation de l'adaptateur par défaut '
WhomadethebluetoothOBDadapter=Celui qui a fabriqué l'adaptateur OBD Bluetooth
Adddisplay=Ajouter une jauge
Selecttypeofdisplay=Sélectionnez le type de jauge
Selecttoautomaticallystartlogg48191353=Sélectionnez pour démarrer automatiquement l'enregistrement lorsque Torque démarre
Clearlogs=Effacer les logs
Startanewlogfileeachtimetorque1829202833=Crée un nouveau fichier chaque fois que Torque se connecte à l'ECU
EcoWarrior=Défenseur de l'écologie
ChoosetheconnectiontypeBluetoothorWiFi=Choisir le type de connexion (Bluetooth ou WiFi)
VehicleSettings=Paramètres du véhicule
OK=OK
StartLogging=DŽmarrer log
StopLogging=Arrter log
GPSPositioning=Positionnement GPS
UseAirplanemode=Utiliser le mode avion
LookingforOBDadapter=Recherche de l'adaptateur OBD
VehicleOBDStandard=Norme OBD du véhicule
AdapterNotes=Notes de l'adaptateur
Displayan'Areyousure'whenyouar1866837230=Afficher un 'Êtes-vous sûr' lorsque vous êtes sur le point de quitter Torque
AlarmManagerdisplayingsetalarms=Gestion des alarmes - affichage des alarmes actives
OBDAdapterInformation=Informations sur l'adaptateur OBD
InCardashboardinstallationsettings=Paramètres d'installation sur le tableau de bord du véhicule
Whenexternalpowerisoffturnonai814458427=Quand l'alimentation extérieure est désactivée, active le mode avion pour économiser la batterie jusqu'à ce que l'alimentation extérieure soit rebranchée
Large=Grand
Selectthealreadypaireddevicetoconnectto=Sélectionnez l'appareil déjà appairé pour s'y connecter
No=Non
ConnectiontoECU=Connexion à l'ECU
Themes=Thèmes
Speedupdataretrievalbynotcalcu1791358539=Accélère l'acquisition des données en ne calculant pas la consommation de carburant
VehicleProfile=Profil du véhicule
Clearfaultcodes=Effacer les codes défaut
VehicleWeightKilogrammes=Poids du véhicule (Kilogrammes)
EnableordisableallspeechinTorque=Activer ou désactiver toutes les voix dans Torque
Sharevia=Partager via \:
Resetdialstodefaultlayout=Réinitialiser les jauges au calque par défaut
Selectathemefromtheonlinethemebrowser=Sélectionner un thème depuis le serveur en ligne
BluetoothSettings=Paramètres Bluetooth
Createnewprofile=Créer un nouveau profil...
ClearfaultsonECU=Effacer les codes défaut sur l'ECU
Tickthisifyouhaveproblemtalkin549646885=Cochez si vous avez des problèmes de dialogue avec le véhicule ou si les jauges se 'gèlent'
Selectvehicleprofiletoload=Sélectionnez le profil du véhicule à charger
connected=connecté
Dashinstallationsettings=Paramètres d'installation sur le tableau de bord
ToggleHUDmode=Passer en mode tête haute
UsedegreesCelsiusinteadofFahrenheit=Utiliser les degrées Celsius au lieu des degrées Fahrenheit
FileLoggingInterval=Intervale d'enregistrement dans le fichier
Playalarmsoundandthenspeechaboutthealarm=Jouer un son d'alarme puis parler à propos de l'alarme
AdjustnewRPMdialdisplaystobest242686983=Ajuster le nouvel affichage des trs/min pour mieux afficher jusqu'à la valeur maximale des trs/min
Automaticallyturnbluetoothonwh1586171933=Active automatiquement le Bluetooth quand l'application est lancée, et désactive le Bluetooth quand l'application est arrêtée
AdapterVersion=Version de l'adaptateur
Delete=Effacer
Aligndisplaystoagridwhenchangingposition=Aligner les jauges sur la grille lors du changement de position
configuringOBD=configuration de l'OBD
Portnumber=Numéro du port
Allowdevicetoturnoff=Permet à l'appareil de se mettre en veille
SelectFuelType=Sélectionnez le type de carburant
Showawarningonhandsetswithbrok1263863050=Afficher une alerte pour les kits mains libre avec des mauvais pilotes Bluetooth (ERD79)
'devicePleaseselectapermanentp1643664369='. Merci de sélectionner un appareil appairé en permanence dans les paramètres\!
Don'tconvertnegativepsireadingstoin/Hg=Ne pas convertir les Psi négatifs en in/Hg
Createuserdefinablealerts=Créer des alertes personnalisables
Selectanimagefromthegallerytou1845718654=Sélectionnez une image depuis la gallerie pour utiliser en tant qu'arrère-plan
Portthattheadapterlistenson=Port sur lequel l'appareil écoute
Nothingtoreport=Rien à signaler
Formatlogvalues=Formater les valeurs
Addnew=Ajouter un nouveau...
Small=Petit
Informationaboutthebluetoothadapter=Informations à propos de l'adaptateur Bluetooth
Removeallalarms=Effacer toutes les alarmes
Yes=Oui
ConnectionType=Type de connexion
Adapternotfoundretrying=Adaptateur non trouvé, nouvel essai...
DataLogging&Upload=Enregistrement et upload des données
Units=Unités
isscanning=scanne
Waitingforconnection=En attente d'une connexion
Showtips=Afficher les astuces
OnlyuploadGPSandOBDdatawhencon1426572208=Envoyer seulement les données GPS et OBD quand connecté à l'interface OBD
Adddefaultset=Ajouter un ensemble par défaut
PowerSaveMode=Mode économie d'énergie
AddcustomFaultLogItem=Ajouer un élément défaut personnalisé
Selectwhattolog=Sélectionner quoi enregistrer
AdapterPIDreadspeed=Vitesse de lecture des données de l'adaptateur
Edit=Editer
Notpresent=Non présent
Refresh=Rafraichir
WarnifGPSisoff=Avertir si le GpS est éteint
AddcustomPID=Ajouter un capteur personnalisé
Togglemapautoscrolling=Activer le défilement automatique de la carte
Add/RemovePIDsAccess'KnockReta1991302190=Ajouter / Supprimer des sondes - Accéder à la sonde 'Knock Retard' ici)
Showsthenotificationbarintheda468207226=Montrer la barre de notification dans la vue tableau de bord
Whothevehicleismadeby=Qui a fabriqué le véhicule
Autorotate=Tourner automatiquement
OBD2AdapterSettings=Paramètres de l'adaptateur OBDII
Formatthevaluesto2decimalplaces=Formater les valeurs sur 2 décimales
Selectthedelayatwhichtologdata1082241353=Sélectionner le délai d'enregistrement des données dans le fichier
Themepreferences=Paramètres de thèmes
